.........................
.........................
.........................
#########################
#.......................#
#.....................###
#..................##...#
#...............##......#
#............##.........#
#P........##............#
#########################
.........................
.........................
.........................