#########################
#.......................#
###########....##########
#.......................#
#.....#############.....#
#......................D#
###########....##########
#.......................#
#.....#############.....#
#.......................#
###########....##########
#.......................#
#.....#############.....#
#.......................#
###########....##########
#.......................#
#.....#############.....#
#P..........##.........D#
#########################