.........................
.........................
.........................
#########################
#.......................#
#....###.........###....#
#.......................#
#..........##...........#
#.........####..........#
#P.......######.........#
#########################
.........................
.........................
.........................